********************
**S*             G**
**          e***  **
**                **
*********   ****  **
*********         **
********************