********************
**S*             G**
**          e***  **
**                **
*********   ****  **
*********   ****  **
*********   ****  **
*********   ****  **
*********   ****  **
*********    **   **
*********         **
********************