**********************************
**S      ****   ***             **
****     ****    E*    ***      **
*****  E ****         *****  *****
*****    *      **    E***  ******
***            ****            ***
****     *     e**    ****    ****
**      ***           ******   G**
**********************************